######
#....#.####
#....###..#
#.........#
#.........#
########..#
..#..#....#
.##..B...##
.#.@..B..##
.#......##
.#######