######
#....#.####
#....###..#
#..P......#
#..P......#
########..#
..#..#....#
.##..B...##
.#.@B....##
.#......##
.#######

######
#....# ####
#....###..#
##..B.....#
#...@B.#..#
###.B###..#
..#..#PP..#
.##.##P#.##
.#......##
.#.....##
 #######

#########
##.##.P.#
#.##.BP.#
.##.B...#
##.B@.###
#.B..##
#PP.##.##
#...#.##
#####.#

...........#####
..........##...#
..........#....#
....####..#.B.##
....#..####B.B#
....#.....B.B.#
...##.##.B.B.B#
...#..P#..B.B.#
...#..P#......#
#####.#########
#PPPP.@..#
#PPPP....#
##..######
.####

..###########
.##.....#..@#
###.B.BB#...#
#.##B....BB.#
#..#..B.#...#
######.######
#PP.PPB.#.##
#.PP....###
#..PP#####
#########

