######
#....#.####
#....###..#
#..P......#
#..P......#
########..#
..#..#....#
.##..B...##
.#.@B....##
.#......##
.#######